########
#......#
#.....S#
###....#
#....###
#E.....#
########